%%%%%%%
% P.  %
% %%% %
% %.  %
% %%% %
%. G  %
%%%%%%%
